40 40 40 40 40 40 40 40 40 40 40 40 40
40 40 40 40 11 11 11 11 11 40 40 40 40
40 40 40 11 11 11 11 11 11 11 40 40 40
40 40 11 11 11 81 84 87 11 11 11 40 40
11 11 11 11 81 85 85 85 87 11 11 11 44
11 11 11 11 83 85 85 85 89 11 11 11 44
40 40 11 11 11 83 86 89 11 11 11 44 40
40 40 40 11 11 11 11 11 11 11 40 40 40
40 40 40 40 11 11 11 11 11 40 40 40 40
40 40 40 40 40 40 40 40 40 40 40 40 40