40 40 49 11 11 43 46 46 46 46 40 40 40 40 40 40 40
40 49 11 11 11 11 11 11 11 11 43 40 40 40 40 40 40
48 11 11 11 11 11 11 11 11 11 11 43 40 40 40 40 40
48 11 11 11 11 11 11 11 11 11 11 11 43 40 40 40 40
48 11 11 11 11 11 11 11 11 11 11 11 11 43 40 40 40
48 11 11 11 11 41 44 47 11 11 11 11 11 11 43 46 40
48 11 11 11 11 42 40 40 47 11 11 11 11 11 11 11 42
48 11 11 11 11 43 40 40 40 47 11 11 11 11 11 11 42
48 11 11 11 11 11 43 40 40 48 11 11 11 11 11 11 42
48 11 11 11 11 11 11 42 40 48 11 11 11 11 11 11 42
40 44 44 44 44 44 44 40 40 40 44 47 11 11 41 44 40