13 13 13 13 13 12 12 12 12 12 12 12 12 12 12 12 12 12 12 12 40
13 13 13 13 13 12 12 12 12 12 12 12 12 12 12 12 12 12 12 12 40
13 13 13 13 13 12 12 12 12 12 12 12 12 15 12 12 12 15 12 12 40
13 13 13 13 13 12 12 12 12 12 12 20 20 20 20 20 20 20 28 11 42
13 13 13 13 11 21 20 20 20 20 20 20 20 20 20 20 20 26 29 11 42
40 40 40 48 11 26 20 20 20 20 20 20 20 20 20 20 29 11 11 41 40
40 40 40 40 47 11 22 20 20 20 20 20 20 20 20 29 11 11 41 40 40
40 40 40 40 48 11 23 20 20 20 20 20 20 20 29 11 11 41 40 40 40
40 40 40 40 40 47 11 23 20 20 20 20 20 29 11 11 41 40 40 40 40
40 40 40 40 40 40 47 11 26 26 26 26 29 11 11 41 40 40 40 40 40
40 40 40 40 40 40 40 47 11 11 11 11 11 11 41 40 40 40 40 40 40
40 40 40 40 40 40 40 40 44 47 11 11 41 44 40 40 40 40 40 40 40
40 40 40 40 40 40 40 40 42 40 11 11 40 40 40 40 40 40 40 40 40