13 13 11 11 11 11 11 11 11 11 13 13
13 11 11 11 11 11 11 11 11 11 11 13
11 11 11 11 11 11 11 11 11 11 11 11
11 11 11 11 11 11 11 11 11 11 11 11
47 11 11 11 11 11 11 11 11 11 11 41
40 44 47 11 11 11 11 11 11 41 44 40
40 40 40 44 47 11 11 41 44 40 40 40
40 40 40 40 40 44 44 40 40 40 40 40
40 40 40 40 40 40 40 40 40 40 40 40