13 47 48 48 49 13 11 11 13 47 48 48 49 13
13 13 13 13 13 11 11 11 11 13 13 13 13 13
13 13 13 13 11 11 11 11 11 11 13 13 13 13
13 13 13 11 11 11 11 11 11 11 11 13 13 13
13 13 13 11 11 11 11 11 11 11 11 13 13 13
13 13 13 11 11 11 11 11 11 11 11 13 13 13
13 13 13 13 11 11 11 11 11 11 13 13 13 13
13 13 13 13 13 11 11 11 11 13 13 13 13 13
13 13 13 13 13 13 11 11 13 13 13 13 13 13