40 40 40 40 40 40 40 40 40 40 40 40 40
40 40 40 40 11 11 11 11 11 40 40 40 40
40 40 40 11 11 11 11 11 11 11 40 40 40
40 40 11 11 11 11 11 11 11 11 11 40 40
11 11 11 11 11 11 11 11 11 11 11 11 44
11 11 11 11 11 11 11 11 11 11 11 11 44
40 40 11 11 11 11 11 11 11 11 11 44 40
40 40 40 11 11 11 11 11 11 11 40 40 40
40 40 40 40 11 11 11 11 11 40 40 40 40
40 40 40 40 40 40 40 40 40 40 40 40 40