13 47 48 48 49 13 11 11 13 47 48 48 49 13
13 13 13 13 13 11 11 11 11 11 11 16 17 16
13 13 13 13 11 11 11 11 11 11 11 18 19 18
13 13 13 11 11 11 11 11 11 11 11 13 13 13
13 13 13 11 11 11 11 11 11 11 11 13 13 13
13 13 13 11 11 11 11 11 11 11 11 13 13 13
13 13 13 13 11 11 11 11 11 11 13 13 13 13
13 13 13 13 13 11 11 11 11 13 13 13 13 13
13 13 13 13 13 13 11 11 13 13 13 13 13 13