14 14 14 14 14 14 14 14 14 14 14 14 14 14 14 14 14
14 14 14 14 14 14 14 14 14 14 14 14 14 14 14 14 14
14 11 11 11 14 14 14 14 12 12 12 12 12 12 12 12 14
14 11 11 11 14 12 12 12 10 10 10 10 10 10 10 10 14
14 11 11 11 14 10 10 10 18 17 17 17 17 17 17 16 14
14 11 11 11 14 10 10 14 18 12 12 12 12 12 12 16 14
14 11 11 11 14 14 14 14 18 11 11 11 11 11 11 11 14
14 11 11 11 11 11 11 12 18 11 11 11 11 11 11 11 14
14 11 11 11 11 11 11 10 18 11 11 11 11 11 11 11 14
14 14 14 14 14 14 14 14 18 11 11 11 11 11 11 11 14
12 12 12 12 12 12 12 14 14 14 14 14 14 14 14 14 14