12 12 12 12 12 12 12 12 12 12 12 12 12 12 12 12 12 12
12 12 12 12 12 12 12 12 12 12 12 12 12 12 12 12 12 12
12 12 12 12 12 12 12 12 12 12 12 12 12 12 12 12 12 12
12 12 12 12 12 12 12 12 12 12 12 12 11 11 11 11 11 11
12 12 12 11 11 11 11 11 11 11 11 11 11 11 11 11 11 11
12 12 11 11 11 11 11 11 11 11 11 11 11 11 11 11 11 11
12 40 11 11 11 11 11 11 11 11 11 11 11 11 11 11 11 11
40 40 11 11 11 11 11 11 44 44 44 44 44 44 44 44 44 44
40 40 11 11 11 11 11 11 40 40 40 40 40 40 40 40 40 40