3 3 3 3 3 2 2 2 2 2 2 2 2 2 2 2 2 2 2 2 2 2 4
3 3 3 3 3 2 2 2 2 2 2 2 2 2 2 2 2 2 2 2 2 2 4
3 3 3 3 3 2 2 2 2 2 2 2 2 2 2 2 2 2 2 2 5 2 4
3 3 3 3 3 1 0 0 0 0 2 2 2 2 5 2 2 2 2 0 0 1 4
3 3 3 3 1 0 0 0 0 0 0 0 0 0 0 0 0 0 0 0 0 1 4
4 4 4 4 1 0 0 0 0 0 0 0 0 0 0 0 0 0 0 1 1 4 4
4 4 4 4 4 0 0 0 0 0 0 0 0 0 0 0 0 0 1 1 4 4 4
4 4 4 4 4 1 0 0 0 0 0 0 0 0 0 0 0 1 1 4 4 4 4
4 4 4 4 4 4 1 0 0 0 0 0 0 0 0 0 1 1 4 4 4 4 4
4 4 4 4 4 4 4 1 0 0 0 0 0 0 0 1 1 4 4 4 4 4 4
4 4 4 4 4 4 4 4 1 1 1 1 1 1 1 1 4 4 4 4 4 4 4
4 4 4 4 4 4 4 4 4 4 4 1 1 4 4 4 4 4 4 4 4 4 4
4 4 4 4 4 4 4 4 4 4 4 1 1 4 4 4 4 4 4 4 4 4 4