66 66 66 66 66 66 66 66 69 62 65 65
11 11 11 11 11 11 11 11 11 63 66 66
12 12 12 12 12 12 12 12 54 12 12 12
12 12 12 12 12 12 12 12 54 12 12 12
12 12 12 12 12 12 12 12 54 12 12 12
12 12 12 12 12 12 12 12 54 12 12 12
12 12 12 12 12 12 12 12 54 12 12 12
12 12 12 12 12 12 12 12 54 12 12 12
67 11 11 11 11 11 11 11 11 11 11 61
65 67 11 11 11 11 11 11 11 11 61 65