4 4 4 4 4 4 4 4 4 4 4 4 4 4 4 4 4
4 4 4 4 4 4 4 4 4 4 4 4 4 4 4 4 4
4 1 1 1 4 4 4 4 2 2 2 2 2 2 2 2 4
4 1 1 1 4 2 2 2 0 0 0 0 0 0 0 0 4
4 1 1 1 4 0 0 0 8 7 7 7 7 7 7 6 4
4 1 1 1 4 0 0 4 8 2 2 2 2 2 2 6 4
4 1 1 1 4 4 4 4 8 1 1 1 1 1 1 1 4
4 1 1 1 1 1 1 2 8 1 1 1 1 1 1 1 4
4 1 1 1 1 1 1 0 8 1 1 1 1 1 1 1 4
4 4 4 4 4 4 4 4 8 1 1 1 1 1 1 1 4
2 2 2 2 2 2 2 4 4 4 4 4 4 4 4 4 4