11 11 11 11 11 28 28 28 28 28 28 28 11 11 11
30 28 28 28 28 40 23 26 21 26 24 40 28 28 33
31 23 26 26 24 40 22 27 22 27 22 40 23 24 34
31 22 27 27 22 40 15 15 15 15 15 40 22 22 34
31 15 15 15 15 26 15 15 15 15 15 40 15 15 34
31 15 15 15 15 27 15 15 15 15 16 40 15 15 34
31 15 15 15 15 15 15 15 15 15 15 15 15 15 34
31 15 15 15 15 36 29 29 15 29 29 29 15 29 35
32 29 29 29 29 35 11 11 11 11 11 11 11 11 11
11 11 11 11 11 11 11 11 11 11 11 11 11 11 11