13 13 13 13 13 12 12 12 12 12 12 12 12 12 12 12 12 12 12 12 12 12 40
13 13 13 13 13 12 12 12 12 12 12 12 12 12 12 12 12 12 12 12 12 12 40
13 13 13 13 13 12 12 12 12 12 12 12 12 12 12 12 12 12 12 12 15 12 40
13 13 13 13 13 11 10 10 10 10 12 12 12 12 15 12 12 12 12 10 10 11 42
13 13 13 13 11 10 10 10 10 10 10 10 10 10 10 10 10 10 10 10 10 11 42
40 40 40 48 11 10 10 10 10 10 10 10 10 10 10 10 10 10 10 11 11 41 40
40 40 40 40 47 10 10 10 10 10 10 10 10 10 10 10 10 10 11 11 41 40 40
40 40 40 40 48 11 10 10 10 10 10 10 10 10 10 10 10 11 11 41 40 40 40
40 40 40 40 40 47 11 10 10 10 10 10 10 10 10 10 11 11 41 40 40 40 40
40 40 40 40 40 40 47 11 10 10 10 10 10 10 10 11 11 41 40 40 40 40 40
40 40 40 40 40 40 40 47 11 11 11 11 11 11 11 11 41 40 40 40 40 40 40
40 40 40 40 40 40 40 40 44 44 47 11 11 41 44 44 40 40 40 40 40 40 40
40 40 40 40 40 40 40 40 40 42 40 11 11 40 40 40 40 40 40 40 40 40 40