51 54 54 54 54 54 54 54 54 54 54 57
52 51 54 54 54 54 54 54 54 54 57 58
52 52 51 54 54 54 54 54 54 57 58 58
52 52 52 55 55 55 55 55 55 58 58 58
52 52 52 55 55 55 55 55 55 58 58 58
52 52 53 56 56 56 56 56 56 59 58 58
52 53 56 56 56 56 56 56 56 56 59 58
53 56 56 56 56 56 56 56 56 56 56 59