11 11 11 11 11 11 11 11 71 74 74 74
11 11 11 11 11 11 11 11 72 75 75 75
74 74 74 77 11 11 11 11 72 75 75 75
75 75 75 78 11 11 11 11 72 75 75 75
75 75 75 78 11 11 11 11 72 75 75 75
75 75 75 78 11 11 11 11 72 75 75 75
75 75 75 78 11 11 11 11 72 75 75 75
75 75 75 78 11 11 11 11 72 75 75 75
76 76 76 79 11 11 11 11 73 76 76 76
11 11 11 11 11 11 11 11 11 11 11 11
11 11 11 11 11 11 11 11 11 11 11 11
11 11 11 11 11 11 11 11 11 11 11 11
11 11 11 11 11 11 11 11 11 11 11 11
11 11 11 11 11 11 11 11 11 11 11 11
11 11 11 11 11 11 11 11 11 11 11 11
11 11 11 11 11 11 11 11 11 11 11 11
11 11 11 11 11 11 11 11 11 11 11 11
11 11 11 11 11 11 11 11 11 11 11 11
54 54 54 54 54 54 54 54 54 54 54 54
54 54 54 54 54 54 54 54 54 54 54 54