70 70 70 70 79 11 11 11 11 11 13 13 13 13 13 11 11 71
70 70 70 79 11 11 11 11 11 11 11 13 13 13 11 11 71 70
70 70 79 11 11 11 11 11 11 11 11 11 13 11 11 11 72 70
70 79 11 11 11 11 11 11 11 11 11 11 11 11 11 11 72 70
79 11 11 11 11 11 11 11 11 11 11 11 11 11 11 11 72 70
11 11 11 11 11 11 11 11 11 11 11 11 11 11 11 11 72 70
11 11 11 11 11 11 11 11 11 11 11 11 11 11 11 11 73 76
11 11 11 11 11 11 11 11 11 11 11 71 74 74 74 74 74 74
11 11 11 11 11 11 11 11 11 11 11 72 70 70 70 70 70 70