72 75 75 75 78 72 75 75 75 75 78 52
73 76 76 76 79 73 76 76 76 76 79 52
11 11 11 11 11 11 11 11 11 11 11 52
11 11 11 11 11 11 11 11 11 11 11 52
11 11 11 11 11 11 11 11 11 11 11 52
11 11 11 11 11 11 11 11 11 11 11 52
11 11 11 11 11 11 11 11 11 11 11 52
71 74 74 74 74 74 74 74 74 74 77 52